########################################
#                                      #
#                                      #
#                                      #
#                                      #
#                                      #
#                                      #
#                                      #
#             ############             #
#                                      #
#                                      #
#                                      #
#                                      #
#                                      #
#                                      #
#                                      #
#                                      #
#                                      #
#                                      #
#                                      #
#                                      #
#                                      #
########################################